111111111111111
110001111110011
11100011P000011
111111111110111
111111111110111
100000E00000011
100F0000C000001
1100100000F0011
110001111110011
11100C11C000011
111111111111111