111111111111111
110010000000011
110001111110011
11100011P000011
111111111110111
111111111110111
100000E00000011
10000000C000001
111111111111111
111111111111111
